o 4 -5 l
z 30 2 l
o 24 -4 l
o 25 -4 l
o 26 -4 l
o 27 -4 l
o 28 -4 l
o 29 -4 l
o 30 -4 l
o 31 -4 l
o 32 -4 l
g 27 -1 l
g 36 -2 l
g 39 0 l
g 43 7 l