o 4 -5 u d
z 30 2 u d
o 24 -4 u d
o 25 -4 u d
o 26 -4 u d
o 27 -4 u d
o 28 -4 u d
o 29 -4 u d
o 30 -4 u d
o 31 -4 u d
o 32 -4 u d
g 27 -1 u d
g 36 -2 u d
g 39 0 u d
g 43 7 u d