o 50 -15 u d
o 49 -15 u d
o 48 -15 u d
o 47 -15 u d
o 46 -15 u d
o 45 -15 u d
o 51 -15 u d
o 52 -15 u d
o 53 -15 u d
o 54 -15 u d
o 55 -15 u d
o 56 -15 u d
o 57 -15 u d
o 58 -15 u d
o 59 -15 u d
o 60 -15 u d
o 61 -15 u d
o 62 -15 u d
o 63 -15 u d
o 64 -15 u d
o 65 -15 u d
o 66 -15 u d
o 67 -15 u d
z 10 -9 u d
z 10 -7 u d
g 32 -10 u d
g 34 -10 u d
g 36 -10 u d
r 80 -12 u d