o 50 -15 l
o 49 -15 l
o 48 -15 l
o 47 -15 l
o 46 -15 l
o 45 -15 l
o 51 -15 l
o 52 -15 l
o 53 -15 l
o 54 -15 l
o 55 -15 l
o 56 -15 l
o 57 -15 l
o 58 -15 l
o 59 -15 l
o 60 -15 l
o 61 -15 l
o 62 -15 l
o 63 -15 l
o 64 -15 l
o 65 -15 l
o 66 -15 l
o 67 -15 l
z 10 -9 l
z 10 -7 l
g 32 -10 l
g 34 -10 l
g 36 -10 l
r 80 -12 l